id,betAmount,numMines,balanceBefore,profit,balanceAfter,win
1,500.0,1,1000.0,25.0,1025.0,Win
2,512.0,1,1025.0,-512.0,513.0,Loss
3,513.0,1,513.0,5.13,518.13,Win
4,513.0,1,518.13,5.13,523.26,Win
5,523.0,3,523.26,355.64,878.9,Win
6,878.0,3,878.9,395.1,1274.0,Win
7,878.0,3,1274.0,395.1,1669.1,Win
8,834.0,3,1669.1,-834.0,835.09,Loss
